p;p;p;p;p;p;p;p;p;p;p;p;p;p;p;p;p;p;p;p;p;p;p;p;p;p;p;p;p;p;p;p;p;p;p;p;p;p;p;p
p;w;w;w;f;w;w;w;w;f;w;w;w;w;f;w;w;w;w;f;w;w;w;w;f;w;w;w;w;f;w;w;w;w;f;w;w;w;w;p
p;w;w;w;f;w;w;w;w;f;w;w;w;w;f;w;w;w;w;f;w;w;w;w;f;w;w;w;w;f;w;w;w;w;f;w;w;w;w;p
p;w;w;w;f;w;w;w;w;f;w;w;w;w;f;w;w;w;w;f;w;w;w;w;f;w;w;w;w;f;w;w;w;w;f;w;w;w;w;p
p;f;f;f;f;f;f;f;f;f;f;f;f;f;f;f;f;f;f;f;f;f;f;f;f;f;f;f;f;f;f;f;f;f;f;f;f;f;f;p
p;w;w;w;f;w;w;w;w;f;w;w;w;w;f;w;w;w;w;f;w;w;w;w;f;w;w;w;w;f;w;w;w;w;f;w;w;w;w;p
p;w;w;w;f;w;w;w;w;f;w;w;w;w;f;w;w;w;w;f;w;w;w;w;f;w;w;w;w;f;w;w;w;w;f;w;w;w;w;p
p;w;w;w;f;w;w;w;w;f;w;w;w;w;f;w;w;w;w;f;w;w;w;w;f;w;w;w;w;f;w;w;w;w;f;w;w;w;w;p
p;w;w;w;f;w;w;w;w;f;w;w;w;w;f;w;w;w;w;f;w;w;w;w;f;w;w;w;w;f;w;w;w;w;f;w;w;w;w;p
p;f;f;f;f;f;f;f;f;f;f;f;f;f;f;f;f;f;f;f;f;f;f;f;f;f;f;f;f;f;f;f;f;f;f;f;f;f;f;p
p;w;w;w;f;w;w;w;w;f;w;w;w;w;f;w;w;w;w;f;w;w;w;w;f;w;w;w;w;f;w;w;w;w;f;w;w;w;w;p
p;w;w;w;f;w;w;w;w;f;w;w;w;w;f;w;w;w;w;f;w;w;w;w;f;w;w;w;w;f;w;w;w;w;f;w;w;w;w;p
p;w;w;w;f;w;w;w;w;f;w;w;w;w;f;w;w;w;w;f;w;w;w;w;f;w;w;w;w;f;w;w;w;w;f;w;w;w;w;p
p;w;w;w;f;w;w;w;w;f;w;w;w;w;f;w;w;w;w;f;w;w;w;w;f;w;w;w;w;f;w;w;w;w;f;w;w;w;w;p
p;f;f;f;f;f;f;f;f;f;f;f;f;f;f;f;f;f;f;f;f;f;f;f;f;f;f;f;f;f;f;f;f;f;f;f;f;f;f;p
p;w;w;w;f;w;w;w;w;f;w;w;w;w;f;w;w;w;w;f;w;w;w;w;f;w;w;w;w;f;w;w;w;w;f;w;w;w;w;p
p;w;w;w;f;w;w;w;w;f;w;w;w;w;f;w;w;w;w;f;w;w;w;w;f;w;w;w;w;f;w;w;w;w;f;w;w;w;w;p
p;w;w;w;f;w;w;w;w;f;w;w;w;w;f;w;w;w;w;f;w;w;w;w;f;w;w;w;w;f;w;w;w;w;f;w;w;w;w;p
p;w;w;w;f;w;w;w;w;f;w;w;w;w;f;w;w;w;w;f;w;w;w;w;f;w;w;w;w;f;w;w;w;w;f;w;w;w;w;p
p;f;f;f;f;f;f;f;f;f;f;f;f;f;f;f;f;f;f;f;f;f;f;f;f;f;f;f;f;f;f;f;f;f;f;f;f;f;f;p
p;w;w;w;f;w;w;w;w;f;w;w;w;w;f;w;w;w;w;f;w;w;w;w;f;w;w;w;w;f;w;w;w;w;f;w;w;w;w;p
p;w;w;w;f;w;w;w;w;f;w;w;w;w;f;w;w;w;w;f;w;w;w;w;f;w;w;w;w;f;w;w;w;w;f;w;w;w;w;p
p;w;w;w;f;w;w;w;w;f;w;w;w;w;f;w;w;w;w;f;w;w;w;w;f;w;w;w;w;f;w;w;w;w;f;w;w;w;w;p
p;w;w;w;f;w;w;w;w;f;w;w;w;w;f;w;w;w;w;f;w;w;w;w;f;w;w;w;w;f;w;w;w;w;f;w;w;w;w;p
p;f;f;f;f;f;f;f;f;f;f;f;f;f;f;f;f;f;f;f;f;f;f;f;f;f;f;f;f;f;f;f;f;f;f;f;f;f;f;p
p;w;w;w;f;w;w;w;w;f;w;w;w;w;f;w;w;w;w;f;w;w;w;w;f;w;w;w;w;f;w;w;w;w;f;w;w;w;w;p
p;w;w;w;f;w;w;w;w;f;w;w;w;w;f;w;w;w;w;f;w;w;w;w;f;w;w;w;w;f;w;w;w;w;f;w;w;w;w;p
p;w;w;w;f;w;w;w;w;f;w;w;w;w;f;w;w;w;w;f;w;w;w;w;f;w;w;w;w;f;w;w;w;w;f;w;w;w;w;p
p;w;w;w;f;w;w;w;w;f;w;w;w;w;f;w;w;w;w;f;w;w;w;w;f;w;w;w;w;f;w;w;w;w;f;w;w;w;w;p
p;p;p;p;p;p;p;p;p;p;p;p;p;p;p;p;p;p;p;p;p;p;p;p;p;p;p;p;p;p;p;p;p;p;p;p;p;p;p;p

{
    "Map": {
        "mapName": "Default map",
        "hero_cell_xy": [20, 20]
    },
    "Treasure": [
        {
        "x": 4,
        "y": 3,
        "state": 1,
        "lock": "True",
        "loot":
            {
            "Gold": 100,
            "Item": ["i1", "i1"]
            }
        },
        {
        "x": 2,
        "y": 7,
        "state": 1,
        "lock": "True",
        "loot":
            {
            "Gold": 140,
            "Item": [null]
            }
        }
    ],
    "Trap": [
        {
        "x": 1,
        "y": 7
        }
    ]
}
